WWWWWWWWWWWWWWWWWWWWWWWWWWWWWWWWWWWWWWWWWWWWWWWWWWWWWWWWWWWWWWWW
WEEEEEEEEWEEEEEEEEWEEEEEEEEEEEEEEEEEEEEEEEEEEEEEEEEEEEEEEEEEEEEW
WEEWWWWEEWEEWWWWWWWEEWWWWWWWWWWWWWWWWWWWWWWWWWWWWEEWWWWWWWWWWEEW
WEEEEEWEEEEEWEEEEEEEEWEEEEEWEEEEEWEEEEEEEEEEEEEEWEEEEEWEEEEEEEEW
WWWWEEWEEWWWWEEWWWWWWWEEWEEWEEWEEWEEWWWWWWWWWWEEWWWWEEWEEWWWWWWW
WEEEEEWEEWEEEEEWEEEEEEEEWEEEEEWEEWEEEEEEEEWEEWEEWEEEEEWEEEEEWEEW
WEEWWWWEEWEEWWWWEEWWWWWWWWWWWWWWWWWWWEEWWWWWWWEEWWWWWWWWWWEEWWWW
WEEWEEEEEWEEWEEWEEWEEEEEEEEEEEEEEWEEWEEWEEEEEWEEEEEEEEWEEWEEEEEW
WEEWWWWWWWEEWWWWEEWEEWWWWWWWWWWEEWEEWEEWEEWEEWWWWEEWEEWWWWWWWEEW
WEEEEEEEEWEEWEEEEEWEEEEEWEEEEEWEEWEEWEEEEEWEEEEEWEEWEEEEEEEEEEEW
WEEWWWWEEWEEWEEWWWWWWWEEWWWWEEWEEWWWWWWWWWWWWWEEWEEWWWWWWWWWWWWW
WEEWEEEEEWEEWEEEEEEEEWEEEEEWEEWEEEEEEEEEEEEEEWEEWEEEEEEEEEEEWEEW
WEEWEEWWWWEEWWWWWWWWWWWWWEEWEEWWWWWWWWWWWWWEEWEEWWWWEEWWWWEEWWWW
WEEWEEWEEEEEEEEEEEEEEEEEEEEWEEEEEEEEEEEEEEWEEWEEEEEWEEWEEWEEEEEW
WEEWEEWEEWWWWWWWWWWWWWWWWWWWWWWEEWWWWWWWEEWWEWWWWEEWEEWEEWWWWEEW
WEEWEEEEEEEEWEEEEEWEEEEEEEEEEEEEEEEEEEEWEEWEEEEEWEEWEEEEEWEEEEEW
WEEWWWWWWWEEWEEWEEWEEWWWWEEWWWWWWWEEWWWWWWWEEWEEWEEWWWWEEWEEWWWW
WEEWEEEEEEEEWEEWEEWEEEEEWEEEEEEEEWEEWEEEEEEEEWEEWEEWEEWEEWEEEEEW
WEEWEEWWWWWWWEEWEEWWWWEEWEEWWWWWWWWWWEEWWWWWWWWWWEEWEEWEEWWWWEEW
WEEWEEWEEEEEEEEWEEEEEWEEWEEEEEWEEEEEWEEEEEEEEEEEWEEWEEEEEWEEWEEW
WEEWEEWEEWWWWWWWWWWWWWEEWWWWEEWEEWWWWWWWWWWWWWEEWEEWWWWWWWWWWEEW
WEEWEEEEEEEEEEEEEEEEEEEEEEEWEEWEEEEEWEEWEEWEEEEEWEEEEEEEEWEEWEEW
WEEWEEWWWWWWWWWWWWWWWWWWWWWWWWWWWWEEWWWWWWWEEWWWWWWWWWWEEWWWWEEW
WEEWEEEEEEEEWEEEEEWEEWEEEEEEEEWEEWEEWEEWEEEEEEEEEEEEEEWEEWEEEEEW
WWWWWWWWWWEEWEEWEEWEEWEEWWWWEEWWWWEEWWWWEEWWWWEEWWWWWWWEEWEEWWWW
WEEEEEWEEEEEWEEWEEWEEWEEWEEWEEEEEEEEWEEWEEWEEEEEWEEEEEWEEWEEEEEW
WEEWWWWEEWWWWEEWEEWEEWEEWWWWWWWWWWWWWWWWEEWEEWWWWEEWEEWEEWWWWWWW
WEEEEEEEEEEEWEEWEEWEEWEEEEEEEEEEEEEEEEEWEEWEEWEEEEEWEEWEEEEEEEEW
WWWWWWWWWWEEWWWWEEWEEWWWWWWWWWWWWWWWWEEWEEWEEWWWWWWWWWWWWWWWWEEW
DEEEEEEEEEEEEEEEEEWEEEEEEEEEEEEEEEEEWEEEEEWEEEEEEEEEEEEEEWEEEAEW
WWWWWWWWWWWWWWWWWWWWWWWWWWWWWWWWWWWWWWWWWWWWWWWWWWWWWWWWWWWWWWWW