ED......EE
EWWWWWW.WW
EWEEE...EE
EWWWW.WWWW
EW....WEEE
EW.EWWWEEE
EW.EWEW.AE
EW.WWEW.EE
EW..W...EE
EEW...EEEE