WWWWWWWWWWWWWWWWWWWWWWWWWWWWWWWWWWWWWWWWWWWWWWWWWWWWWWWWWWWWWWWWWWWWWEAEW
WEEEWEEEEEEEEEEEEEEEWEEEEEEEEEEEEEEEWEEEEEEEEEEEWEEEEEEEEEEEEEEEEEEEWEEEW
WEEEWEEEWWWWWWWWWEEEWEEEWWWWWEEEWWWWWWWWWEEEWWWWWEEEWWWWWEEEWWWWWEEEWEEEW
WEEEEEEEEEEEEEEEWEEEEEEEWEEEWEEEEEEEEEEEWEEEEEEEEEEEWEEEWEEEWEEEEEEEWEEEW
WWWWWWWWWEEEWEEEWWWWWWWWWEEEWWWWWWWWWEEEWWWWWEEEWEEEWEEEWEEEWWWWWWWWWEEEW
WEEEEEEEWEEEWEEEEEEEEEEEEEEEWEEEEEEEEEEEWEEEWEEEWEEEWEEEWEEEEEEEEEEEWEEEW
WEEEWEEEWWWWWWWWWWWWWEEEWEEEWEEEWWWWWWWWWEEEWWWWWEEEWEEEWWWWWWWWWEEEWEEEW
WEEEWEEEEEEEEEEEEEEEWEEEWEEEWEEEEEEEWEEEEEEEEEEEWEEEEEEEEEEEWEEEEEEEWEEEW
WEEEWWWWWWWWWWWWWEEEWWWWWEEEWWWWWEEEWEEEWWWWWEEEWWWWWWWWWEEEWEEEWWWWWEEEW
WEEEEEEEEEEEWEEEEEEEWEEEWEEEEEEEWEEEWEEEEEEEWEEEEEEEEEEEWEEEWEEEEEEEEEEEW
WEEEWWWWWEEEWWWWWEEEWEEEWWWWWEEEWEEEWWWWWWWWWEEEWEEEWEEEWEEEWWWWWWWWWWWWW
WEEEEEEEWEEEEEEEWEEEWEEEWEEEEEEEWEEEEEEEWEEEEEEEWEEEWEEEWEEEEEEEWEEEEEEEW
WWWWWWWWWWWWWEEEWEEEWEEEWEEEWWWWWWWWWEEEWEEEWWWWWEEEWEEEWWWWWEEEWWWWWEEEW
WEEEEEEEEEEEWEEEWEEEEEEEEEEEWEEEEEEEWEEEWEEEEEEEWEEEWEEEEEEEWEEEEEEEEEEEW
WEEEWWWWWEEEWEEEWWWWWWWWWEEEWWWWWEEEWEEEWWWWWEEEWWWWWEEEWWWWWWWWWWWWWEEEW
WEEEWEEEEEEEWEEEEEEEEEEEWEEEEEEEEEEEWEEEEEEEWEEEWEEEWEEEEEEEEEEEEEEEWEEEW
WEEEWEEEWWWWWWWWWEEEWEEEWWWWWEEEWWWWWWWWWEEEWEEEWEEEWWWWWWWWWWWWWEEEWEEEW
WEEEWEEEEEEEEEEEWEEEWEEEWEEEWEEEWEEEEEEEEEEEWEEEEEEEEEEEEEEEWEEEWEEEEEEEW
WEEEWWWWWWWWWEEEWEEEWEEEWEEEWWWWWEEEWWWWWWWWWEEEWWWWWWWWWEEEWEEEWWWWWWWWW
WEEEWEEEEEEEWEEEWEEEWEEEEEEEEEEEWEEEEEEEEEEEWEEEWEEEEEEEWEEEEEEEEEEEEEEEW
WEEEWEEEWWWWWEEEWWWWWEEEWWWWWEEEWWWWWWWWWEEEWWWWWEEEWEEEWWWWWWWWWEEEWEEEW
WEEEWEEEEEEEEEEEEEEEEEEEWEEEEEEEEEEEWEEEEEEEEEEEEEEEWEEEEEEEEEEEEEEEWEEEW
WEDEWWWWWWWWWWWWWWWWWWWWWWWWWWWWWWWWWWWWWWWWWWWWWWWWWWWWWWWWWWWWWWWWWWWWW