EWWEWWEWWEWWEWWEWWEWWEDEEWWEWWEWWEWWEWWEWWEWWE
WEEEEEEEEEEEEEEEEEEEEWEEEEEEEEWEEEEEWEEEEEWEEW
WEEWWWWEEWWWWWWWWWWWWWEEWWWWEEWEEWEEWEEWEEWEEW
WEEEEEWEEEEEWEEEEEEEEEEEEEEWEEEEEWEEEEEWEEWEEW
WWWWEEWWWWEEWEEWWWWWWWWWWEEWWWWWWWWWWEEWEEWEEW
WEEEEEWEEEEEWEEEEEWEEEEEWEEEEEEEEEEEWEEWEEWEEW
WWWWWWWEEWWWWEEWWWWEEWEEWWWWWWWEEWEEWEEWEEWEEW
WEEEEEEEEWEEEEEWEEEEEWEEEEEEEEEEEWEEWEEWEEEEEW
WEEWWWWWWWEEWWWWEEWEEWWWWEEWWWWWWWEEWEEWWWWWWW
WEEEEEEEEEEEWEEEEEWEEEEEWEEWEEEEEWEEWEEWEEEEEW
WWWWWWWWWWWWWEEWWWWWWWEEWWWWEEWWWWEEWEEWEEWEEW
WEEEEEEEEEEEWEEWEEEEEWEEEEEWEEEEEWEEWEEEEEWEEW
WEEWEEWEEWWWWEEWEEWEEWWWWEEWWWWEEWEEWWWWWWWEEW
WEEWEEWEEEEEWEEWEEWEEEEEWEEEEEEEEWEEEEEWEEWEEW
WEEWEEWWWWEEWEEWEEWWWWEEWWWWWWWWWWWWWEEWEEWEEW
WEEWEEEEEWEEEEEEEEEEEWEEWEEEEEEEEEEEWEEWEEEEEW
WWWWWWWEEWWWWWWWWWWEEWWWWEEWWWWWWWEEWEEWWWWWWW
WEEEEEWEEWEEEEEWEEEEEEEEEEEWEEEEEWEEWEEWEEEEEW
WEEWEEWWWWEEWEEWEEWWWWWWWWWWEEWEEWEEWEEWEEWEEW
WEEWEEWEEEEEWEEWEEEEEEEEEEEWEEWEEWEEWEEEEEWEEW
WEEWEEWEEWWWWWWWEEWWWWWWWEEWEEWEEWWWWWWWWWWEEW
WEEWEEWEEWEEEEEWEEEEEWEEEEEWEEWEEEEEEEEWEEEEEW
WEEWEEWEEWEEWEEWWWWEEWEEWWWWWWWEEWWWWEEWEEWWWW
WEEWEEEEEWEEWEEWEEEEEWEEEEEEEEWEEEEEWEEWEEEEEW
WEEWWWWWWWEEWEEWWWWWWWWWWWWWEEWEEWEEWWWWWWWEEW
WEEEEEEEEWEEWEEEEEWEEEEEWEEEEEWEEWEEWEEEEEWEEW
WEEWWWWEEWEEWWWWEEWEEWEEWEEWWWWWWWEEWEEWEEWEEW
WEEWEEEEEWEEWEEEEEWEEWEEEEEWEEEEEWEEWEEWEEWEEW
WEEWEEWWWWEEWEEWWWWEEWWWWWWWEEWEEWEEWEEWWWWEEW
WEEWEEEEEWEEWEEWEEEEEEEEEEEEEEWEEEEEWEEEEEWEEW
WEEWEEWWWWEEWWWWEEWWWWWWWWWWWWWEEWWWWEEWEEWEEW
WEEWEEEEEWEEEEEEEEWEEEEEEEEEEEWEEEEEWEEWEEEEEW
WEEWWWWEEWWWWWWWWWWEEWWWWWWWEEWWWWEEWWWWWWWWWW
WEEWEEEEEWEEEEEEEEEEEWEEEEEEEEWEEWEEEEEEEEEEEW
WEEWEEWWWWWWWWWWWWWEEWEEWWWWWWWEEWEEWWWWWWWEEW
WEEWEEEEEWEEEEEWEEEEEWEEWEEEEEWEEEEEWEEEEEWEEW
WEEWWWWEEWEEWEEWEEWWWWEEWEEWWWWEEWWWWEEWEEWWWW
WEEWEEEEEWEEWEEWEEEEEWEEEEEWEEEEEWEEEEEWEEEEEW
WEEWWWWWWWEEWEEWEEWEEWWWWWWWEEWWWWEEWWWWWWWEEW
WEEWEEEEEEEEWEEWEEWEEWEEEEEWEEWEEEEEEEEWEEEEEW
WEEWEEWEEWWWWEEWEEWEEWEEWEEWEEWWWWWWWEEWEEWWWW
WEEEEEWEEEEEWEEWEEWEEWEEWEEWEEEEEEEEEEEWEEWEEW
WEEWWWWWWWEEWEEWEEWEEWEEWWWWEEWWWWWWWWWWEEWEEW
WEEEEEWEEEEEWEEEEEWEEWEEWEEEEEWEEEEEEEEWEEWEEW
WWWWWWWEEWWWWWWWEEWWWWEEWEEWEEWEEWWWWEEWEEWEEW
WEEEEEEEEWEEEEEWEEWEEEEEWEEWEEWEEEEEWEEWEEWEEW
WEEWWWWWWWEEWWWWEEWEEWWWWEEWEEWEEWEEWWWWEEWEEW
WEEEEEEEEWEEEEEWEEWEEEEEEEEWEEWEEWEEEEEWEEWEEW
WWWWWWWEEWEEWEEWEEWWWWWWWWWWWWWEEWEEWEEWEEWEEW
WEEEEEWEEWEEWEEWEEEEEWEEEEEWEEEEEWEEWEEWEEEEEW
WEEWEEWEEWWWWEEWEEWWWWEEWEEWEEWEEWWWWEEWEEWWWW
WEEWEEEEEEEEEEEWEEEEEEEEWEEEEEWEEWEEEEEEEEEEEW
WWWWWWWWWWWWWWWWWWWWWWWWWWWWWWWWWWAEWWWWWWWWWW