WWWEEWWEWWEEWWWWWEWWWWEWWWWWEWWWWEWWWW
EWEEEWWWWWEEEEWEEEWEEWEWEWEWEWEEEEWEEE
EWEEEWWWWWEEEEWEEEWWWWEWEWEWEWWWEEWWWW
EWEEEEWWWEEEWEWEEEWEEWEWEEEWEWEEEEEEEW
WWWEEEEWEEEEWWWEEEWEEWEWEEEWEWWWWEWWWW
EEEEEEEEEEEEEEEEEEEEEEEEEEEEEEEEEEEEEE
EEEEEEEEEEEEEEEEEEEEEEEEEEEEEEEEEEEEEE
EEEWWWWEWWWWEWWWWEWWWWEWEEEWEEWEWEWEEE
EEEWEEEEWEEWEWEEEEWEEWEWWEEWEEWEWEWEEE
EEEWWWEEWWWWEWEWWEWWWWEWEWEWEEWEWEWEEE
EEEWEEEEWEEWEWEEWEWEEWEWEEWWEEEEEEEEEE
DEEWWWWEWEEWEWWWWEWEEWEWEEEWEEWEWEWEEA